Ambivalent = Splittet mellem to modstridende meninger, holdninger, følelser
Kontroversiel = Omdiskuteret
Holisme = Lægger vægt på at betragte fænomener som helheder snarere end som sammensatte enkeltdele
Notorisk = Vanemæssig, en kendsgerning
Verdslig = Ikke-religiøst, alt hvad der ikke har med kirken og religion at gøre
Neurotisk = Nerver og psykiske lidelser
Lækage = Hul, utæthed, læk
Konditori = Bager med fine kager og desserter
Vitalitet = Livskraft, energi
Inkognito = Hemmeligholdelse
Omsonst = Forgæves, til ingen nytte
Distingveret = Adskille, betegne forskelle
Paradoks = Urimeligt og selvmodsigende udsagn som i virkeligheden indeholder en sandhed (fx "At leve er at dø"), urimeligt modsætningsforhold
Homo = Ens
Hetro = Forskellige
Abominabel = Afskyelig
Manifestere = Lade noget komme til klart/konkret udtryk
Nekrofil = Seksuel omgang med lig
Periferi = Udkant af et område + omkreds af en cirkel
Korrespondent = Journalist der rapporterer fra et andet land
Lingeri = Undertøj og sengetøj
Protaganist = Helten i en historie som engagerer sig meget i sin sag
Antagonist = Protaganistens modstander
Havari = Skib forliser/bliver ødelagt
Sofistikeret = Elegant, spidsfindigt
Intellektuel = Forholde sig abstrakt, rationelt og objektivt reflekterende til sin omverden. En bestemt måde at anvende si intelligens på
Præcedens = Juridisk udtryk hvor en dommer tager hensyn til tidligere og lignende domme
Patologisk = Syg
Viral markedsføring = At udnytte eksisterende sociale netværk til at sprede et budskab, fx web 2.0 services på internettet
Nonchalant = Overlegen, skødesløs
Republik = Stat med et overhoved
Provisorisk = Foreløbig, midlertidig
Abdicere = Frasige sig tronen, gå af
Ræsonnere= Tænke logisk, gøre modstand
Jahve = Hebraisk navn for Gud
Dogme = Mening/læresætning bag en religion, ideologi eller lignende. Står ikke til diskussion
Semiotik = Læren om tegn
Ibid(um) = Samme som førnævnte --,,--
Anno Domini (AD) = "I det Herrens år" - følger nutidens kalender og er det samme som e.Kr. eller e.v.t. (efter vor tidsregning)
Post... = Blanding af noget gammelt og nyt, fx "postmoderne" = retning inden for kunst, arkitektur osv., især i 1980'erne, der anvender en blanding af gamle og nye former
Agnosticisme = Synspunkt at vi ikke ved (eller kan vide) noget om et bestemt område, fx at det ikke er muligt at opnå absolut sprituel viden. Står i modsætning til ateisme, der klart afviser Guds eksistens
Diplomati = Videnskaben om statsdokumenter. Bruges i dag for at beskrive kunsten at vælge formuleringer omsorgsfuldt
Trosset = Soldaternes bagland i en krig; folk der servicerer dem (fx kvinder)
Teofani = Guds tilsynekomst
Salomonisk = Vis og retfærdig
Merit = Hvis man allerede har kvalifikationerne, kan man få fritagelse for dele af en uddannelse
Dementi = Offentligt at afkræfte en meddelelse eller rygte
"Den fjerde mur" = Bruges ofte inden for teater. Karakterene i en fiktiv fortælling, film, bog eller fjernsyn, må ikke tilkendegive, at de ved, at de er i en fiktiv verden skabt af et medie
Pacifist = Modstander af krig
Konjunktur = Svingninger i markedsøkonomien
Allokere = Tildele (fordeling)
Æstetik = Det skønne i naturen der vækker glæde, smagfuldt, sansende
Synæsteti = Sammenblanding af æstetiske oplevelser, flere sanser mixes sammen
Carpe diem = Grib dagen, lev livet i dag uden at tænke over morgendagens bekymringer
Karrosseri = Ydre del af bil, hvor de forskellige dele er sat på
Antropologi = Læren om mennesket, indeholder mange undergrene
Etnografi = Kvalitativ beskrivelse af menneskelige/sociale handlinger
Oxymoron = Ord/vending sammensat af modsigende ord, et slags paradoks. Fx "Larmende stilhed" eller "Meget lidt"
Incitament = Ansporing
Likvidere = Slå ihjel, eller sælge firma
Status quo = Bevare tingene som de er
Vitterlig = Åbenlyst, faktisk + almindelig/offentligt kendt
Intermezzo = Mellemspil (kort stykke musik), optrin/hændelse
Interludium = Mellemprodukt
Anakronisme = Noget utidssvarende viser sig, fx i en film fra 1930 hvor en jumbojet viser sig
Parol = Ord/tale - bruges til at adskille det verbale (talte) sprog med det skrevne sprog
Glaciolog = Videnskab om is (gletsjere, indlandsis osv.)
Character indelebilis = Uudslettelig egenskab
Successivt = Efterhånden, lidt efter lidt
Indifferensen = Ligegyldig, upersonlighed, skiller sig ikke ud
Herold = Budbringer for en fornem mand
Føljeton = Fiktion delt op i flere del, fx roman eller tegneserie der bliver sendt i flere udgaver af et magasin
Avantgarde = En kunster/forfatter/politiker/andet som eksperimenterer inden for deres område med nye innovative idéer - ligesom en pioner
Nihilisme = Filosofisk standpunkt, benægter eksistensen af objektiv moral og erkendelse. Den menneskelige tilstedeværelse har ingen mening, formål eller essentiel værdi
Libido = Lyst/begær/ønske i menneskets sind (Freud). I film kan det blive fremstillet som en vampyr- eller varulveskikkelse
Summarisk = Kortfattet, i store træk
Modus Vivendi = En midlertidig aftale mellem to parter, en måde at leve videre på
Intervenere = Gribe ind, lægge sig imellem
Emanciperet = En måde at opnå politisk rettighed eller lighed
Intelligibel = Evnen til at blive forstået (på sin intelligens)
Monogami = Ægteskab med to parter (man har kun én partner og ikke flere [polygami])
Indicium = Tegn på at noget er sandsynligt - indicier = blive dømt på bevismateriale der sandsynliggør at den anklagede er skyldig
Semantik = Ords betydning (undergren inden for lingvistik [sprogforskning])
Platonisk = Ikke kropsligt/fysisk/seksuelt
Benefice = Lykke, gavn
In nuce = I sammentrængt form
Altruisme = Det modsatte af egoisme, hvor man sætter andre mennesker højere end sig selv
Insolvent = Bruges i regnskabsmæssigheder, hvor en virksomheds gæld overstiger dets aktiviteter --> kan blive erklæret konkurs
Prekær = "Det bliver en køn forestilling/historie/etc."
Hetz = Pil ~ angreb (fx i medierne)
Agitatorisk = Ophidsende
Opus = En kunstners samlede værker/arbejder
Demagog = Nedsættende udtryk for en person, som forsøger at ophidse/forføre andre med usaglig og stærkt følelsesbetonet retorik
Narcissist = Person som er overdrevent selvoptaget, og som bruger så meget energi på at blive bekræftet af omverden
Palindrom = Ord eller sætning der kan læses bog forfra og bagfra, fx "En af dem, der red med fane"
Coutume = Sædvaneret
Imbecil = Ord brugt om mental retarderet (idiot)
Surrogat = Erstatning for noget, fx surrogat fængsling = komme på ungdomsfængsel eller hospital (hvis man er under 18 eller syg)
Insinuere = Antyde
Gestikulation = Fagter og håndbevægeler
Ekstrapolation = Køre noget ud i sin yderste konsekvens
Superlativ = Tillægsord bøjet i højeste grad, fx "Høj, højere, højest"
Sækulariseret = Ikke-religiøs
Placebo = Snydemedicin (fx lykkepiller)
Eureka = Græsk udtryk for "Jeg har fundet det!"
Cadeau = Gave/foræring
Esoterisk (lære) = Noget skjult/indre
Pragmatism = Filosofi, hvor teoriers og begrebers sandhedsværdi afgøres af deres nytte, funktioner og praktiske konsekvenser
Metonym = Reducerer et stort begreb til en overskuelig størrelse. Udelukker helheden og udvælger noget specifikt. Sætter fokus.
Paradigme = Fælles regler, symboler, begreber, modeller, metoder inden for et bestemt felt (fx videnskab). En slags fælles ramme og værdier
Aksion = Ubetvivlsom sandhed
Solipsism = Filosofisk udtryk; eksisterer tingene virkeligt, eller er det bare en illusion, som vi ser gennem øjet?
Zeitgeist = Tidsånd. En slags trend/mode for en historisk periode
Empati = Evnen til at genkende og forstå andres følelser. I empatien føler man sig ind i den anden
Sympati = Evnen til at vise følelser som følge af en anden persons følelser/lidelser, dvs. at man selv oplever samme følelse som personen. I sympatien føler man med den anden.
Schadenfreude = Man glædes af andres lidelse
Ambidexterity = Man kan bruge både højre og venstre hånd
Psuedo = Falsk, noget giver sig ud for at være et eller andet, det ikke er, selvom det er tæt på
Intentionelle fejlslutning = Man forveksler værkets betydning i bred forstand med forfatterens intention. Fx ringer man til forfatteren for at høre om budskabet i et digt
Ækvivalens = Af samme værdi, overensstemmelse
Doktrin = Kort og spidsformuleret sætning
Esoterisk = Hemmelig, skjult, indre viden
Amatør = At elske (en hobby) frem for at tjene penge på det (professionel)
Cutting-edge technology
Apokalypse = Afsløring, enden på verden som vi kender de
Kotyme = Vane, skik
Flamboyant = Flammende
Ipso facto = Ved selve gerningen, by the fact itself
Psykedelisk = bevisthedsudvidende, noget som forandrer (beriger) sindets virkelighedsopfattelse
Dosmerseddel = Huskeseddel
De facto (standard) = Den gængse metode. Noget, der findes en udbredt praksis af, uden nødvendigvis at være universel og have en lov som begrundelse
Apophenia = Man ser et mønster/tendens/forbindelse i data, som egentlig er fuldstændig tilfældigt
Tabula Rasa = ubeskrevet tavle, et menneske fødes uden erfaringer/meninger og med ren bevidsthed. Denne bliver derefter påvirket af verdens omstændigheder
Nominalisme = Nominalisterne er skeptikere, der tvivler på sandheden, og de mener, at man ikke kan bevise guds eksistens ud fra et begreb om det guddommelige. Kun udsagn, der hviler på erfaring, er sande (empirisme). Troen kan derfor ikke bygge på fornuften, men på Bibelen og kirkens autoritet
Tautologi = "Samme sag". Logisk udsagn, der er sandt for alle tildelinger af værdier til udtrykket. Bruges grammatisk til at sige det samme to gange (dobbeltkonfekt), fx "snavset og beskidt" eller "en gratis gave"
Autodafé = Tilintetgørelse af bøger ved brænding på bålet fordi de anses for politisk farlige el. moralsk fordærvelige
Animositet = Bitter fjendtlighed eller had
Paulun = Hyggeligt og roligt opholdssted eller bolig
Incitere = Anspore, fremkalde, sætte i gang
En pasant = Forbigående, løseligt
Fæces = Afføring, lort
Psykedelisk = Bevisthedsudvidende, noget som forandrer (beriger) sindets virkelighedsopfattelse
Epistemologi = Erkendelsesteori
Vertigo = Svimmelhed
Fetich = Man tillægger en genstand overvældende meget værdi
Anciennitet = Erfaring, hvor længe man har været i en stilling
Columbusæg = Simpel løsning på tilsyneladende umulig opgave. Historien om Columbus der fik et æg til at stå ved at banke den ene ende en smule flad
Dysleksi = Ordblindhed
Flamboyant = Farvestrålende
Magnum opus: En kunstners største værk
Polisk = Snu, listig
Gonzo-journalistik = Mere "in-the-field" reportage-agtig måde at skildre en historie på, hvor konventionelle stilarter og normer tilsidesættes. Leger med grænsen mellem det fiktive og det virkelige
Autodidakt = En selvlært person, som ikke har modtaget undervisning, men selv lært sit håndværk
Distræt = Åndsfraværende, glemsom
Coup de grâce = Sidste nådestød
Raison d'être = Grunden til at eksistere
Demagog = Kunsten til at forføre med sine taleevner. Nedsættede udtryk for en person, som forsøger at ophidse andre med usaglig og stærkt følelsesbetonet retorik
Braille-alfabetet = Punktskrift, det første skriftlige sprog for blinde
Synæstesi = Samsansning, et sanseindtryks fremkalden af fornemmelse fra andet sanseområde
Lukrativ = Indbringende, profitabel
Eunoia = velvilje: at ville gøre noget for at hjælpe andre uden nødvendigvis at forsøge at spinde guld på det
Peripeti = En uventet drejning
Portmanteau - to ord kombineret sammen giver en ny betydning, fx breakfast + lunch = brunch
Antithesis - Modsætninger, bruges ofte i retorik til at opstille kontraster mellem to modstridende idéer
Raison d'être = Eksistensgrundlag
Memento mori = Husk du skal dø
Emanciperet = Frigjort
Pareidolia = Psykologisk fænomen der får tilfældige stimuli (ofte lyd eller billeder) til at have en tilsyneladende betydning; fx at man ser ansigter i daglidagsgenstande (http://www.steampunk.dk/?tag=pareidolia)
Polemisk = Stridslysten
Antropomorfisme = Menneskelig form; fx at et abstrakt begreb har symboliseres i menneskeform
Titulær = Har en titel uden tilsvarende embede
Dekadent = I forhold, degenereret
Whistleblower - En whistleblower (da.: "fløjteblæser") er betegnelse for en person, der afdækker og informerer om hvad han anser som kritisable eller direkte ulovlige forhold i selskaber, organisationer eller offentlige institutioner, hvor den pågældende er eller har været ansat eller på en anden måde involveret
Teatralsk = Overdrevent dramatisk
Idiosynkrasi = Undtagelse; noget der er særegent for en enkelt person eller gruppe, og der forhindrer denne person eller gruppe i at blive beskrevet gennem en regel eller ved hjælp af en kategori
Transactive memory: Et minde til noget, som referer til viden (fx internettet, en bog, telefon, etc.)
Semantik = Ordets betydning
Kuriosum = Mærkværdighed, pudsighed
Megalomanisk = Har med storhedsvanvid at gøre
Anakronisme = Når tiden ingen betydning har
In flagrante = På fersk gerning
Ostentativ = Pralende, udfordrende

Condescension = Nedladenhed
Escapism = Virkelighedsflugt
Deluge = Oversvømmelse
Monastery = Munkekloster
e.g. = Exempli gratia, "for the sake of example"
i.e. = Id est, "that is", "in other words"
Urgent = Akut/haster
Mnemonic = Hjælpemiddel til at huske, hukommelsesfremmende teknik
Gloomy = Mørk, dyster
Shallow = Overfladisk
Prejudice = Fordom
Colloquial = Tale-/hverdagssprog
Subnormal/Simple = Underbegavet
Stubborn = Stædig
Vacant = Tom
Busybody = Person der blander sig i andres sager
Ubiquity = Allestedsnærværelse
Omnibus = Omfattende
Disturbance = Uro
Epiphany = Åbenbaring eller helligtrekongersdag
Conduit = Vandledning, rør, kanal
Cumbersome = Besværlig
Insane asylum = Sindssygeanstalt
Fertilizer = Kunstgødning
Seaweed = Tang
Vault = Boksrum + Hvælving
Disguise = Tilsløring
Perilous = Farefuld
Dilapidated = Forfaldent
Quell = Undertrykke
Fallout = Radioaktivt nedfald + Efterspil
Protaganist = Hovedperson
Mischief = Unoder, gavtyv, spilopmager
Maiden = Ugift, jomfruerejse, pigenavn, ungmø
Crescent= Halvmåne, tiltagende måne
Homage = Hyldest
Despite = Til trods for, selvom
Drool = Savle
Goo = Klæbrig masse
Reminiscent = Minder om noget
Denominator = Nævner (fx fællesnævneren)
Armadillo = Bæltedyr
Ambush = Bagholdsangreb
Dilute = Fortynde
Conviction = Overbevisning, domfældelse
Ephemera = Døgnflue/døgnvæsen
Dubious = Tvivlende, usikker
Raconteur = Fortæller
Havok = Ødelæggelse, nederlag, blodbad
Wasteland = Ødemark
Chrono = Stopur
Layman = Lægmand
Inhabitant = Indbygger
Utensil = Redskab
Pedigree =Stamtavle, herkomst
Snag = Hage
Turnstile = Tælleapparat
Onerous = Byrdefuld
Mudslining = Mudderkastning
Curriculum = Pensum, undervisningsplan
Iterative = Iterativ, gentagende
Comprehensive = Vidtspændende
Embed = Indkapsle
Uncanny = Mystisk
Grim = Streng, ubarmhjertig, grum
Infamous = Berygtet
Discern = Skelne, opdage, erkende
Amalgamation = Sammenlægning
Vivid = Levende
Immersion = Fordybelse
Denote = Betegne
Anxiety = Bekymring, uro, angst
Ballistic = Edderspændt
Evoke = Vække
Unification = At forene
Rural = Landlig
Circumvent = Omgå
Apathy = Sløvhed, apati
Mortage = Huslån
Predominant = Fremherskende
Intrepid = Dristig
Awe = Ærefrygt
Maple = Ahorn
Banzai charge = Japansk infanteriangreb, ofte selvmord, under WW2
Mutal = Indbyrdes, fælles (fx ven)
Dismal = Dyster, trist
Gay = (også) lystig, glad
Tranqul = Rolig, stille
Magi = De hellige tre konger, magi/trolddom
Grocer = Købmand
Parsimony = Sparsommelighed
Instigate = Tilskynde, anspore, ophidse
Mistress = Frue
Mendicancy = Tiggeri
Vestibule = Forhal
Sterling = Ægte, helstøbt
Slender = Slank, spinkel, småt begavet
Envy = Misunde
Hash = Hakke i stykker
Fob = Lille (ur)lomme
Meretricious = Uægte
Ornamentation = Udsmykning
Mammoth = Mammut, kæmpe
Quail = Forfærdet, tabe modet
Terrify = Forfærde
Peculiar = Besynderlig
Inconsequential = Ulogisk, uden sammenhæng, selvmodsigende
Wit = Intelligens, forstand
Alas = Desværre
Comb = Kam
Wig = Paryk
Wrath = Vrede, forbitrelse
Hesitate = Tøve
Implementation = Udførsel
Pit = Hul/grav
Sierra = Bjergryg/-kæde, sav
Tenacity = Hårdnakkethed
Crayon = Farveblyant/-kridt
Pinnacle = Tårn, spir, højdepunkt
Orphaned = Forældreløs
Moron = Åndssvag person, sinke
Prey = Bytte/offer
Perception = Sanseindtryk/opleve
Gore = Splatter, blodige scener
Widow = Enke
Skirmish = Kæmpe i spredt orden
Wagon = Vogn
Buzzard = Grib
Coyote = Prærieulv
Tenacious = Klæbrig, sej, stædig
Prank = Gavtyvstreger/spilopper
Vintage = Fremragende + veteran + vinhøst/årgang
Behemoth = Kæmpe
Mediocrity = Middelmådighed
Genereic = Fælles, generel
Obstacle = (For)hindring, vanskelighed
Crescendo = Højdepunkt (fx i symfoni)
Shrine = Helligdom, tempel
Void = Hulrum, tomt
Grid = Et slags (strøm)net
Mundane = Verdslig, dagligdags, jordbunden
Arcane = Hemmelig, mystisk, skjult
Singularity = Teknologien udvikler sig så hurtigt, at vi ikke kan forudse fremtiden (fx næste to år, næste måned eller næste dag)
Indispensability = Nødvendighed
Proponent = Fortaler
Baptise = Døbe
Fugitive = Flygtig, kortvarig
Lunatic = Vanvittig/sindssyg
Wow = Ed, løfte
Sanctuary = Tilflugtssted
Seldom = Sjældent
Affiliation = Tilslutte, tilknytte
Cataclysm = Katastrofe, oversvømmelse, ødelæggelse
Proprioception = Menneskets bevidsthed om sin krops position i det fysiske rum
Ostensibly = Tilsyneladende
Epiformise = essensen af noget
Lingo franca = Et fremmed sprog
Audacity = Dristighed
Tenacity = Vedholdenhed
Paragon = Mønster(elev)
Renegade = Frafalden, overløbe
Debris = (mur)brokker
Quintessentially = fuldkommen
Bias = Skævhed, fordom, forudindtagethed, ensidighed, retning, hældning, partisk
Punny = Sølle, ubetydelighed, svag, lille
Deviant = Afviger
Indifference = Ligegyldighed
Galanising = Opildne (forzinke)
Aforementioned = Føromtalte
Vanquish = Besejre, overvinde
Hitherto = Indtil nu, hidtil
Quasi = Til en vis grad, ligner/minder om, delvis ~ semi/pseudo
Pulp fiction = Triviallitteratur
Assembly = Samling, montage
Epitaph = Mindesmærke ved gravsten
Fallacy = Forkert argumentation, tager ofte udgangspunkt i følelser i retorik
Rebuttal = Bevismateriale som fremlægges for at modbevise andre beviser
Culprit = Nedværdigende ord om den skyldige i en retssag
Vanguard = Fortrop i militær forstand
Salvation = Frelse, redning
Retribution = Straf, gengældelse
Contemporary = Samtidig, jævnalderende
Metamorphose = Forvandle
Shtick = Fidus, gimmick - en person som kan noget unikt. Bruges ofte ironisk/humoristisk
Et al = Og andre
Err = Fejle
Ambience = Omgivelser, atmosfære
Idiosyncrazy = Særegenhed, særhed
Tender = Fremføre, tilbyde, øm, blid
Liability = Tilbøjelighed, ansvar
Aptitude = Talent
Arbitrary = Vilkårlig
Weriness = (verdens)træthed
Dread = frygt, rædsel, skræk
Debris = Ruiner, rester, affald
Serendipity = Evnen til at gøre fund, imens man leder efter noget helt andet
Conundrum = (ord)gåde
Midget = Dværg/gnom
Closure = Aflukning
Props = (teater)rekvisitter
Hoodlum = Gangster, bølle
Sanctuary = Helligdom
Pundit = Lærd vismand, ekspert (også ironisk)
Truism = Noget der er så indlysende, at det ikke er værd at nævne
Vertigo = Svimmelhed
Terra incognita = Ukendt landområde, bruges inden for kartografi
Penumbra = Halvskygge (astronomi)
Affordance = Visuel tilkendegivelse af en genstands egenskaber (fx knapper, døre, maskiner)
Legitimacy = Lovlighed, legitimitet, retmæssighed, rimelighed, berettigelse
Segue = Smooth transition fra et emne til et andet (bruges ofte inden for journalistik)
Resentment = (ranklement) Oplevelsen af en negativ følelse (fx anger og had) som et resultat af en ugerning
Roost = Soveplads til fugle
Ventriloquism = Bugtaler
Ambiguity = Bruges når noget, under særlige omstændigheder, kan tolkes på flere forskellige måder (fx inden for matematik eller skrivning). Ikke det samme som "vague", hvilket bruges om manglende præcision af information
Sophomore = Term i USA der beskriver andetårs-studerende i high school eller universitetet
Specularity = Visuel fremstilling af lysrefleksioner (fx i 3D-grafik)
Doohickey = En måde at referere til en person, hvis navn man ikke kan huske
Obnoxious = Noget meget irriterende/harmfuldt
Artisan = Håndværker
Doohickey = En vag betegnelse for noget (fx en dims), man ikke kender det rigtige navn på
Dingus = Betegnelse for noget/nogen, man ikke lige kan huske hvad hedder
Harbinger = Nogen som kommer i forvejen for at fortælle om en kommende begivenhed
Verisimilitude = (truthlikeness) graden/kvaliteten af realismen i noget fiktivt (fx bog eller film)
Agency = a characters ability to plan, act and exert self-control
Taciturn = Tavs, fåmælt
Assessment = Vurdering, bedømmelse, evaluering
Reciprocal = Gensidig
Verisimilitude = Sandhedspræg
Procrastination = Tøve
Contemporary = Moderne
Vigilance = Årvågenhed
Instigator = Initiativtager

En grøn skov består af grønne træer
At save grenen, man selv sidder på, over
Gud er et incitament for eskapisme. Gud er en undskyldning; noget man kan gemme sig bag.
Det kræver 47 muskler i ansigtet at se sur ud. Men kun tre at smile. Så hvorfor ikke bare være doven?
At bede en drukkende mand om at svømme
Fikumdik - En lyssky handling, fiksfakseri, lumskeri osv.
Humbug
Fesent
Kvaksalver
Ruskumsnusk
Moletjavs
Mettevuns
Mudderklirrer
Lirekassemand
Pusling
Nonsens
Mosegris
Jublikum publer
Kammersjuk
Knoldesparker
Lakaj
Murmeldyr
Fatamorgana
Vagabond
Flueknepperi
Hudløs ærlig
Fra ende til anden
Volapyk
Dengang ruder konge var knægt
En elefant i en glasbutik
At træde nogens sandslot i stykker
Ramasjang
Hurlumhej
Nogle gange skal man fokusere på selve osten i stedet for dens huller
Først troede man, at alle ballonerne var blevet frigjort på én gang, men så kommer der én med et helt nyt vognlæs
Det er ikke fordi, at du har opfundet det nye hul i donutten
Vi kører på automatik: En bygning var i brand, og brandvæsenet kom for at hjælpe. De havde sat trampoliner og puder ud, og folk hoppede uden tøven ned. Dog var der én kvinde, som ikke turde pga. sin lille baby. Så kom en berømt amerikansk fodboldspiller og sagde, at han nok skulle gribe babyen. Moderen gik efter megen overvejelse med til at slippe barnet. Hun kaster dog skævt, så fodboldspilleren er nødt til at kaste sig ud på vejen for at gribe barnet. Han griber det, ruller rundt på jorden og står til sidst triumferende med barnet i hænderne - indtil at han giver det et ordentligt spark med foden og råber "Touchdown!"
Mange siger, at det handler om selve rejsen frem for destinationen, men menneskets hjerne er nu engang mål-orienteret. Mens du dybsindig stirrer dig blind på den flotte regnbue, kan en anden nå at have fundet krukken med guld før dig!
Døgenigt
Stahut
Klamphugger - en dygtig håndværker der hugger klamper specifikt til et skib
Fittelihut
It's possible some rabbits could be pulled from a hat
Kinamands chance
Af pommeren til
Der kan få andre end lemminger til at styrte sig selv ud over skrænten
Røv og nøgler
Livets store mysterium: Er lyset tændt når køleskabsdøren er lukket?
Det er som pudekamp i mørke
Tanketorsk
Put a Gun in my head and paint the wall with my brains
Same same but different
Potato portato
Mismask
Pærevælling
Cutting-edge technology
Som at gå over på den anden side af åen for at hente vand
Som at få en kage OG få lov til at spise den
Closing the barn door after the horse has already escaped
Gedehams
Niggedukke
Jack of all trades, master of none
Tørvetriller
Lurendrejer
Ogginok
Kispus
Milliard-million
Can't see the forest for the trees
Dikkedarer
Et lys der brænder med dobbelt styrke holder kun halvt så længe
Skomagerens søn går i hullede sko
Mumbojumbo
Være skakmat før spillet overhovedet er begyndt
Extravaganza
Hvis man fortier et spøgelse, vokser det (grønlandsk ordsprog)
Funktion før form (gameplay before style)
Galimatias (vred person)
Karambolage
Yadda yadda yadda (osv.)
In the land of the blind the one-eyed man is king
Whimsical
Pusseløjerligt
Stahut
Ækvilibristisk